11111111111111111
100000C01000C10E1
1P1001100000CC011
11111111111111111